    changePokemonButton: "Sostituisci il Pokémon",
    searchBattle: "Cerca Combattimento",

    wantToBattle: "Vuoi iniziare un Combattimento?",
    waitForPlayer: "Ricerca di un Giocatore Avversario in corso...",

    noTeam: "Non hai una Squadra.",
    TeamFainted: "Ricerca Fallita. Tutti i tuoi Pokémon sono esausti",

    // battle
    battlePlayerNotAccepted: "Il Giocatore Avversario ha perso la connessione prima dell'inizio del Combattimento.<br><br>Prova più tardi.",
    battleCancelled: "Il Combattimento è stato Annullato.",
    battleAlreadyEnded: "Il Combattimento è già finito.",
    battleWaitForPlayer: "In Attesa della Mossa Avversaria...",
    battleMoveUsed: (pokemonName, moveName) => `<span class="battle-log-pokemonname" style="color:#63ff78">${pokemonName}</span> usa <span class="battle-log-movename" style="color:#ff6374">${moveName}</span>.`,
    battleMoveFailed: "Ma fallisce...",
    battleAttackMissed: (pokemonName) => `L'attaco di <span class="battle-log-pokemonname" style="color:#63ff78">${pokemonName}</span> è fallito.`,
    battleNotEffective: "Non è molto efficace...",
    battleEffective: "E' super efficace!",
    battleNoEffect: "Non ha alcun effetto...",
    battleCriticalHit: "Attacco Critico!",
    battleNotAwaitingMove: "Hai gia selezionato questa Mossa.",
    battleMultipleHits: (amount) => `Ha colpito ${amount} volte!`,
    battleStatUp1: (pokemonName, statName) => `<span class="battle-log-pokemonname" style="color:#63ff78"> Sale di poco ${statName} di ${pokemonName}</span>.`,
    battleStatUp2: (pokemonName, statName) => `<span class="battle-log-pokemonname" style="color:#63ff78"> Sale di molto ${statName} di ${pokemonName}</span>!`,
    battleStatUp3: (pokemonName, statName) => `<span class="battle-log-pokemonname" style="color:#63ff78"> Sale drasticamente ${statName} di ${pokemonName}</span>!!`,
    battleStatDown1: (pokemonName, statName) => `<span class="battle-log-pokemonname" style="color:#63ff78"> Cala di poco ${statName} di ${pokemonName}</span>.`,
    battleStatDown2: (pokemonName, statName) => `<span class="battle-log-pokemonname" style="color:#63ff78"> Cala di molto ${statName} di ${pokemonName}</span>!`,
    battleStatDown3: (pokemonName, statName) => `<span class="battle-log-pokemonname" style="color:#63ff78"> Cala drasticamente ${statName} di ${pokemonName}</span>!!`,

    // status effects
    battleEnemySleeping: (pokemonName) => `<span class="battle-log-pokemonname" style="color:#63ff78">${pokemonName}</span> si è Addormentato.`,
    battleEnemyParalysis: (pokemonName) => `<span class="battle-log-pokemonname" style="color:#63ff78">${pokemonName}</span> è stato Paralizzato.`,
    battleEnemyPoison: (pokemonName) => `<span class="battle-log-pokemonname" style="color:#63ff78">${pokemonName}</span> è stato Avvelenato.`,
    battleEnemyToxic: (pokemonName) => `<span class="battle-log-pokemonname" style="color:#63ff78">${pokemonName}</span> è stato Gravemente Avvelenato.`,
    battleEnemyBurned: (pokemonName) => `<span class="battle-log-pokemonname" style="color:#63ff78">${pokemonName}</span> è stato Scottato.`,
    battleIsParalyzed: (pokemonName) => `<span class="battle-log-pokemonname" style="color:#63ff78">${pokemonName}</span> è Paralizzato e non può attaccare.`,
    battleEnemyConfused: (pokemonName) => `<span class="battle-log-pokemonname" style="color:#63ff78">${pokemonName}</span> è Confuso.`,
    battleEnemyEndConfusion: (pokemonName) => `<span class="battle-log-pokemonname" style="color:#63ff78">${pokemonName}</span> non è più Confuso.`,
    battleEnemyFrozen: (pokemonName) => `<span class="battle-log-pokemonname" style="color:#63ff78">${pokemonName}</span> è stato Congelato.`,
    battleIsSleeping: (pokemonName) => `<span class="battle-log-pokemonname" style="color:#63ff78">${pokemonName}</span> Dorme, e non può attaccare.`,
    battleConfused: (pokemonName) => `<span class="battle-log-pokemonname" style="color:#63ff78">${pokemonName}</span> è Confuso, così Confuso da colpirsi da solo.`,
    battleIsFrozen: (pokemonName) => `<span class="battle-log-pokemonname" style="color:#63ff78">${pokemonName}</span> è Congelato, e non può attaccare.`,
    battleFlinched: (pokemonName) => `<span class="battle-log-pokemonname" style="color:#63ff78">${pokemonName}</span> ha Ciondolato, e non può attaccare.`,
    battleHealed: (pokemonName) => `<span class="battle-log-pokemonname" style="color:#63ff78"> Gli HP di ${pokemonName}</span> sono stati revitalizzati.`,
    battleWokeUp: (pokemonName) => `<span class="battle-log-pokemonname" style="color:#63ff78">${pokemonName}</span> si è Svegliato.`,
    battleUnthawed: (pokemonName) => `<span class="battle-log-pokemonname" style="color:#63ff78">${pokemonName}</span> si è Scongelato.`,
    battleRecoilApplied: (pokemonName) => `<span class="battle-log-pokemonname" style="color:#63ff78">${pokemonName}</span> soffre per il danno da colpo.`,
    battlePoisonDamage: (pokemonName) => `<span class="battle-log-pokemonname" style="color:#63ff78">${pokemonName}</span> soffre per l'Avvelenamento.`,
    battleBurnDamage: (pokemonName) => `<span class="battle-log-pokemonname" style="color:#63ff78">${pokemonName}</span> soffre per la Scottatura.`,
    battlePokemonChanged: (LastPokemonName, CurrentPokemonName) => `<span class="battle-log-pokemonname" style="color:#63ff78">${LastPokemonName}</span> è stato sostituito da <span class="battle-log-pokemonname" style="color:#63ff78">${CurrentPokemonName}</span>.`,

    // field effects
    battleRainEnd: `Ha smesso di piovere.`,
    battleRainStarted: `Ha iniziato a piovere.`,
    battleHailStarted: `Ha iniziaro a grandinare.`,
    battleHailDamage: 'Il Pokémon è stato colpito dalla grandine.',
    battleHailEnd: 'Ha smesso di grandinare.',
    battleSandstormStarted: "Una tempesta di sabbia è iniziata.",
    battleSandstormDamage: "Il Pokémon è stato colpito dalla tempesta di sabbia.",
    battleSandstormEnd: "La tempesta di sabbia è finita.",
    battleSunStarted: `La luce del sole è abbagliante.`,
    battleSunEnd: `Il sole è andato via.`,

    // battle ended
    BattleWin: "Congratulazioni, hai vinto il Combattimento!",
    BattleLose: "Hai perso il Combattimento!",
    BattleXP: (XP) => `Il tuo Team ha ottenuto ${XP} EXP!`,
    BattleNoXP: "Il tuo Team non ha ottenuto EXP!",
